vhcs_table = German
vhcs_language = German
vhcs_languageSetlocaleValue = de_DE
encoding = iso-8859-1
 do not exist = ist nicht vorhanden
 Has IP address that can not be managed from the destination reseller !<br>This user can not be moved! =  hat IP Adresse, die von dem neuen Wiederverk&auml;ufer nicht verwaltet werden kann!<br>Benutzer kann nicht zugewiesen werden!
 Has unlimited rights for a <b> = Hat limitierte Rechte f&uuml;r ein <b>
 is exceeding limits for a <b> = &Uuberschreitet seine Beschr&auml;nkung f&uuml; <b>
 Is exceeding limits for a <b> = &Uuberschreitet seine Beschr&auml;nkung f&uuml; <b>
 Messages translated =  &Uuml;bersetzungen
 you are logged now as  =  Sie sind momentan angemeldet als:&nbsp;
(Ex. domain-of-your-choice.com) = (z.B.: domain.tld)
(Ex. EUR) = (z.B.: EUR)
(usually named backup_YYY_MM_DD.tar) = <i>(Bezeichnung: domain.tld_backup_tt-mm-jjjj_hh-mm-ss.tar.gz)<i>
[New] = [Neu]
[Re] = [AW]
* denotes mandatory field. = * Ben&ouml;tigte Felder
&nbsp; = &nbsp;
</b> = </b>
</b> Address !<br>Edit reseller aborted! = Adresse! <br> Die Bearbeitung des Wiederverk&auml;ufers wurde abgebrochen!
</b> amount, present on the system! =  Summe, auf dem System!
</b> in a destination reseller,<br> = </b> in einen Ziel-Wiederverk&auml;ufer,<br>
</b> In a destination reseller,<br> = </b> in einen Ziel-Wiederverk&auml;ufer,<br>
</b> records on the system! = </b> Eintr&auml;ge im System!
</b> records, present on the system! = </b> Eintr&auml;ge im System vorhanden!
</b> Service !<br> = </b> Dienst! <br>
</b> Service can not be disabled !<br>There is <b> = </b> Service kann nicht deaktiviert werden!<br>Es sind <b>
</b> Service can not be limited !<br>specified number is smaller then <b> = </b> Service kann nicht beschr&auml;nkt werden!<br>Angegebener Wert ist kleiner als <b>
</b> Service can not be limited !<br>Specified number is smaller then <b> = </b> Service kann nicht beschr&auml;nkt werden!<br>Angegebener Wert ist kleiner als <b>
</b> Service can not be limited !<br>You are exceeding reseller limits for the <b> = </b> Service kann nicht beschr&auml;nkt werden!<br>Sie &uuml;berschreiten Ihre Beschr&auml;nkung f&uuml;r das <b>
</b> Service can not be unlimited !<br>There is reseller limits for the <b> = </b> Dienst kann nicht beschr&auml;nkt werden!<br>Es gibt Wiederverk&auml;ufer Beschr&auml;nkung f&uuml;r das<b>
</b> service! = </b> Dienst!
</b><br> = </b><br>
<b>Routine maintenance!</b><br><br>VHCS is not available for system changes<br><br>Pleas contact your hosting service provider for more information<br><br>We apologize for any inconvenience and thank you for understanding = <b>Routine maintenance!</b><br><br>VHCS is not available for system changes<br><br>Pleas contact your hosting service provider for more information<br><br>We apologize for any inconvenience and thank you for understanding
<b>Thank You for purchasing</b><br>You will receive an email with more details and information = <b>Danke f&uuml;r Ihre Bestellung</b><br>Sie werden in K&uuml;ze eine E-Mail mit mehr Details und Informationen bekommen
<br>service in destination reseller!<br> = <br>Dienst im Ziel-Wiederverk&auml;ufer!<br>
0 = 0
1 = 1
2 = 2
3 = 3
4 = 4
Access your files through the web interface = Dateien mit dem webbasierten Dateimanager bequem verwalten
Access your mail through the web interface = E-Mails online abrufen, versenden und verwalten
Account name = Kontoname
Action = Aktionen
Active = Aktiv
Acttive = Aktiv
Add = Anlegen
Add admin = Administrator anlegen
Add alias = Domain Alias anlegen
Add Cronjob = Cronjob hinzuf&uuml;gen
Add domain alias = Domain Alias anlegen
Add existing user = Bestehenden Benutzer hinzugef&uuml;gen
Add FTP user = FTP Konto anlegen
Add group = Gruppe anlegen
Add hosting plan = Hosting Paket anlegen
Add mail user = E-Mail Konto anlegen
Add mail users = E-Mail Konto anlegen
Add new button = Neuen Men&uuml;punkt anlegen
Add new IP = Neue IP Adresse anlegen
Add new protected area = Gesch&uuml;tzten Bereich anlegen
Add new user hosting plan = Neues Hosting Paket anlegen
Add On A Domain = Geben Sie eine Domain ein
Add other domains to this account = Weitere Domains diesem Konto hinzuf&uuml;gen
Add plan = Hosting Paket anlegen
Add reseller = Wiederverk&auml;ufer anlegen
Add SQL database = Datenbank anlegen
Add SQL user = Benutzer anlegen
Add subdomain = Subdomain anlegen
Add to the system = Hinzuf&uuml,gen
Add user = Benutzer anlegen
Add/Details = Konto Updaten
Addition in progress = Wird angelegt...
Additional data = Zus&auml;tzliche Daten
Admin log = Adminprotokoll
Admin Log = Adminprotokoll
Admin users = Administratoren
Administrator = Administrator
Administrators = Administratoren
Adminitrators list is empty! = Administratorenliste ist leer!
Alais name = Domain Aliasname
Alias = Domain Aliase
Alias forward = Weiterleitung<br>(Domain Alias)
Alias list is empty! = Es sind keine Domain Aliase im System vorhanden!
Alias list is empty! You can not add FTP accounts there! = Domain Aliasliste ist leer! Sie k&ouml;nnen kein FTP Konto f&uuml;r diesen Domain Alias anlegen!
Alias list is empty! You can not add mail accounts! = domain Aliasliste ist leer! Sie k&ouml;nnen keine E-Mail Konten f&uuml;r diesen Domain Alias anlegen
Alias mail = Normal<br>(Domain Alias)
Alias mails = Normal<br>(Domain Alias)
Alias name = Domain Aliasname
Alias scheduled for addition! = Domain Alias wird angelegt!
Alias scheduled for deletion! = Domain Alias wird gel&ouml;scht!
Alias scheduled for modification! = Domain Alias wird aktualisiert!
Alias(es)<br><i>(-1 disabled, 0 unlimited) = Max. Domain Aliase<br><i>(-1 nicht verf&uuml;gbar, 0 unbegrenzt)
Aliases = Domain Aliase
All = Alle
All closed support tickets deleted successfully! = Alle abgeschlossenen Supportanfragen wurden erfolgreich gel&ouml;scht!
All in = Alle<br>Eing&auml;nge
All open support tickets deleted successfully! = Alle offenen Supportanfragen wurden erfolgreich gel&ouml;scht!
All out = Alle<br>Ausg&auml;nge
All resellers = Alle Wiederverk&auml;ufer
All traffic = Gesamttransfer
All users & resellers = Alle Kunden und Wiederverk&auml;ufer
All users = Alle Kunden
Already in: = Benutzer aus Gruppe
Apache logfiles = Apache Logdateien
Apache logs = Apache Logdateien
Apply changes = &Auml;nderungen &uuml;bernehmen
Are you sure you want to change the status of domain account? = Sind Sie sicher, dass Sie den Status dieser Domain ändern wollen?
Are you sure you want to delete = Sind Sie sicher, dass dieser Eintrag gelöscht werden soll?
Are you sure you want to delete this account? = Sind Sie sicher, dass dieses Konto gelöscht werden soll?
Are you sure you want to delete this order? = Sind Sie sicher, daß Sie diese Bestellung löschen wollen?
Area name = Bereichname
Assign = Zuweisen
Auto email template data updated! = Auto E-Mail Vorlagendaten wurden erfolgreich aktualisiert!
Auto respond = E-Mail Autobeantwortung
Automatic Updates = Automatische Updates
Available for purchasing = Zum Kauf freigeben
Available IPs = Verf&uuml;gbare IP Adressen
Available VHCS updates = Verf&uuml;gbare VHCS Updates
Awstats = AWStats
AwStats = AWStats
Back = Zur&uuml;ck
Backup / Restore = Datensicherung und -wiederherstellung
Backup = T&auml;gliche Sicherung
Backup and restore = Datensicherung und Wiederherstellung
Backup and Restore = Datensicherung und Wiederherstellung
Backup and restore settings = Datensicherung und Wiederherstellung
Backup archive scheduled for restoring! = Datensicherung wird wiederhergestellt...
Behind the name = &nbsp;nach dem Datenbanknamen
Billing Settings = Faktura Einstellungen
Blue = Blau
Button link = Men&uuml;punkt Link (URL)
Button name = Men&uuml;punkt Name
Button target = Men&uuml;punkt Ziel (_top, _blank)
Can not connect as MySQL administrator! = Keine Verbindung zu MySQL als Administrator!
Can Not Connect As MySQL Administrator! = Keine Verbindung zu MySQL als Administrator!
Can not open directory !<br>Please contact your administrator ! = Sie haben keinen Zugriff zu diesem Verzeichnis!<br>Bitte kontaktieren Sie den Serveradministrator!
Can not open file! Please contact your administrator ! = Datei kann nicht ge&ouml;ffnet werden!<br><br>Bitte kontaktieren Sie Ihren Administrator!
Can not read vhcs language file! = Die VHCS Sprachdatei kann nicht gelesen weden!
Cancel = Abbrechen
Cancel order = Bestellung abbrechen
Cannot connect as MySQL administrator! = Kann nicht als MySQL Administrator verbinden!
Catch all = Catch All
Catch all account = Catch All E-Mail Konto
Catch all account scheduled for creation! = Catch All wird im System eingetragen!
Catch all account scheduled for deletion! = Catch All wird gel&ouml;scht!
Catch all mail account can not be created! = Es sind keine Catch All E-Mail Konten im System vorhanden!
CGI / Perl = CGI / Perl Unterst&uuml;tzung
CGI support = CGI Unterst&uuml;tzung
CGI Support: disabled = CGI Service: deaktiviert
CGI Support: enabled = CGI Service: aktiviert
Change = Wechseln
Change password = Passwort &auml;ndern
Change pers. data = Pers&ouml;nliche Daten &auml;ndern
Change personal data = Pers&ouml;nliche Daten &auml;ndern
Change SQL user password = Passwort &auml;ndern
Change user interface = Benutzeroberfl&auml;che wechseln
Check Out = Bestellung Abgeschlossen
Choose = Ausw&auml;hlen
Choose default language = Standard Sprache ausw&auml;hlen
Choose default layout = Standard Design ausw&auml;hlen
Choose dir = Verzeichnis ausw&auml;hlen
Choose hosting plan = Hosting Paket ausw&auml;hlen
Circular = Rundschreiben
City = Stadt
Clear log = Protokoll l&ouml;schen
Click Restore button and the system will<br>restore last daily backup = Klicken Sie auf den <i>Wiederherstellen</i></b> Button und das System<br> wird auf die Sicherung des letzten Tages wiederhergestellt!
Close ticket = Supportanfrage schliessen
Closed tickets = Abgeschlossene Supportanfragen
Command to run: = Auszuf&uuml;rende Befehle:
Company = Firma
Continue = Weiter
Core data = Daten
Costs = Kosten
Country = Land
CPU bogomips = CPU Bogomips
CPU cache = CPU Cache
CPU MHz = CPU MHz
CPU model = CPU Model
CPU system Info = CPU Systeminformation
Create catch all = Catch All anlegen
Create catch all mail account = Catch All E-Mail anlegen
Created by = Erstellt von
Creation date = Erstellt am
Cronjob = Cronjob
Cronjob Manager = Cronjob Verwaltung
Cronjobs = Cronjobs
Currency = Währung
Current password = Aktuelles Kennwort
Custom Apache Logs = Eigene Apache Logdateien
Custom error page was updated! = Fehlerseite wurde aktualisiert!
Custom error pages = Eigene Fehlerseiten
Custom Error Pages = Eigene Fehlerseiten
Custom menu data updated successful! = Men&uuml;punkt wurde aktualisiert!
Custom menu deleted successful! = Men&uuml;punkt wurde gel&ouml;scht!
Custom menus = Individuelle Men&uuml;punkte
Customer data = Kundendaten
Customer ID = Kundennummer
Customer order was removed successful! = Die Bestellung wurde erfolgreich gelöscht!
Customize error pages for your domain = Fehlerseiten f&uuml;r Ihre Domain anpassen
D = Details
Daily backup = T&auml;gliche Sicherung
Database list is empty! = Es sind keine MySQL Datenbanken im System vorhanden!
Database name = Datenbank Name
Database user list is empty! = MySQL Datenbankbenutzerliste ist leer!
Database users = Datenbankbenutzer
Date = Datum
Day = Tag
Day: = Tag
Day(s): = Tag(e)
default = Standard
Default = Standard
Default language changed! = Standard Sprache wurde erfolgreich ge&auml;ndert!
delete = L&ouml;schen
Delete = L&ouml;schen
Delete all = Alle l&ouml;schen
Delete CatchAll = L&ouml;schen
Delete order = Bestellung l&ouml;schen
Deletion in progress = Wird gel&ouml;scht...
Description = Beschreibung
Details = Details
Direction download today backup = Um Ihre Serversicherung herunterzuladen gehen sie wie folgt vor:
Directories = Verzeichnisse
Directory listing = Verzeichnis &Uuml;bersicht
Directory mount point = Zielverzeichnis (Mount Point)
Directory tree = Verzeichnisbaum
Directory tree<br>mount point = Zielverzeichnis (Mount Point)
Disable = Deaktivieren
disabled = Deaktiviert
Disabled = Deaktiviert
Disk [MB]<br><i>(0 unlimited) = Max. Speicherplatz [MB]<br><i>(0 unbegrenzt)</i>
Disk = Speicherplatzverbrauch
Disk in MB = Speicherplatzverbrauch [MB]<br>(Verbraucht / Begrenzung)
Disk limit [Mb]<br><i>(0 unlimited)</i> = Max. Speicherplatz [MB]<br><i>(0 unbegrenzt)</i>
Disk limit [MB]<br><i>(0 unlimited)</i> = Max. Speicherplatz [MB]<br><i>(0 unbegrenzt)</i>
Disk usage = Speicherplatzverbrauch
Disk<br>usage = Speicherplatzverbrauch
Domain = Domains
Domain account = Domain Konto
Domain alias = Domain Aliase
Domain alias added for termination! = Domain Alias wird gel&ouml;scht...
Domain alias added! = Domain Alias wird angelegt!
Domain alias errors = Fehlerhafte Domain Aliases
Domain alias limit expired! = Domain Alias Beschr&auml;nkung wurde erreicht! 
Domain alias modified! = Domain Alias wurde aktualisiert!
Domain alias not added for termination! = Domain Alias wird nicht gel&ouml;scht!
Domain alias not added! = Domain Alias wurde nicht</b> angelegt!
Domain alias not modified! = Domain Alias wurde nicht</b> aktualisiert!
Domain alias you are trying to remove has email accounts !<br>First remove them! = Die zu l&ouml;schende Domain Alias hat noch E-Mail Konten!<br> L&ouml;schen Sie diese zuerst!
Domain alias you are trying to remove has FTP accounts!<br>First remove them! = Die zu l&ouml;schende Domain Alias hat noch FTP Konten!<br> L&ouml;schen Sie diese zuerst!
Domain aliases = Domain Aliase
Domain aliasses = Domain Aliase
Domain details = Domain details
Domain errors = Fehlerhafte Domains
Domain Features = Domain Merkmale
Domain IP = Domain IP Adresse
Domain mail = Normal<br>(Hauptdomain)
Domain mails = Normal<br>(Hauptdomain)
Domain name = Domain Name
Domain properties = Domain Eigenschaften
Domain properties updated successfully! = Domain Eigenschaften wurden aktualisiert!
Domain statistics = Domain Statistik
Domain with that name already exists on the system! = Domain mit angegebenem Namen bereits vergeben!
Domain with this name already exist = Domain mit angegebenem Namen bereits vergeben!
Domain you are trying to remove has domain alias!<br> first remove them ! = Die Domain, die Sie l&ouml;schen m&ouml;chten hat noch Domain Aliase!<br>Bitte l&ouml;schen Sie diese zuerst!
Domain you are trying to remove has email accounts !<br> first remove them ! = Die Domain, die Sie l&ouml;schen m&ouml;chten hat noch E-Mail Konten!<br>Bitte l&ouml;schen Sie diese zuerst!
Domain you are trying to remove has FTP accounts !<br> first remove them ! = Die Domain, die Sie l&ouml;schen wollen hat FTP Konten!<br>Bitte l&ouml;schen Sie diese zuerst!
Domain you are trying to remove has subdomains accounts !<br> first remove them ! = Die Domain, die Sie l&ouml;schen m&ouml;chten hat noch Subdomains!<br>Bitte l&ouml;schen Sie diese zuerst!
Domains = Domains
Done = Fertigstellen
Download the only one file in this directory = Laden Sie die darin befindliche Datei herunter
E-mail = E-Mail
Edit = Bearbeiten
Edit admin = Administrator bearbeiten
Edit button = Men&uuml;punkt bearbeiten
Edit Cronjob = Cronjob bearbeiten
Edit Domain = Domain bearbeiten
Edit domain alias = Domain Alias bearbeiten
Edit email account = E-Mail Konto bearbeiten
Edit error page = Fehlerseiten bearbeiten
Edit FTP user = Benutzer bearbeiten
Edit hosting plan = Hosting Paket bearbeiten
Edit mail auto responder = Autobeantwortung bearbeiten
Edit properties = &Auml;ndern
Edit reseller = Wiederverk&auml;ufer bearbeiten
Edit reseller aborted! = Fehler! Die Bearbeitung dieses Wiederverk&auml;ufers wurde abgebrochen!
Edit user = Benutzer bearbeiten
Email = E-Mail Adresse
Email account not founded! = E-Mail Konto nicht gefunden!
Email Accounts = E-Mail Konten
Email and FTP accounts = E-Mail und FTP Benutzer
Email forward = Weiterleitung<br>(Hauptdomain)
Email marketing = Rundschreiben
Email setup = Willkommen E-Mail Einstellungen
Email Updated = E-Mail Konto wurde aktualisiert!
Email Updated! = E-Mail Konto wurde aktualisiert!
Empty data or wrong field! = Keine oder falsche Eingabe!
Empty list = Die Liste ist leer
Empty List = Die Liste ist leer
Enable = Aktivieren
Enable mail auto responder = Autobeantwortung aktivieren
enabled = Aktiviert
Enabled = Aktiviert
Enduser level = Kunden Benutzeroberfl&auml;che
Enter Address = Adresse angeben
Entered passwords differ from the another! = Die eingegebenen Passw&ouml;rter stimmen nicht &uuml;berein!
Entered passwords differ! = Die eingegebenen Passw&ouml;rter stimmen nicht &uuml;berein!
Entered passwords does not match! = Die eingegebenen Passw&ouml;rter stimmen nicht &uuml;berein!
Error = Fehler
Error 401 (unauthorized) = Fehlerseite 401 (Unautorisiert)
Error 403 (forbidden) = Fehlerseite 403 (Unerlaubt)
Error 404 (not found) = Fehlerseite 404 (Nicht gefunden)
Error 500 (internal server error) = Fehlerseite 500 (Interner Server Fehler)
Error pages = Fehlerseiten
Error we have domain that use this IP! = Fehler: Diese IP wird von mindestens einer Domain benutzt
Error we have reseller that use this IP! = Fehler: Diese IP wird von mindestens einen Reseller benutzt
ERROR: Password not send = Fehler: Kennwort nicht versendet.
ERROR: Security code was not correct! = Fehler: Der Sicherheitscode war nicht korrekt.
ERROR: Unknown user = Fehler: Unbekannter Benutzer.
Execute = Ausf&uuml;hren
Execute query = Query ausf&uuml;hren
Execute SQL query = MySQL Query ausf&uuml;hren
Existing SQL users = Existierender MySQL Benutzer
Export = Exportieren
Extras = Extra
Fax = Telefax
Feature = Funktion
Filemanager = Datei Manager
Filesystem system Info = Dateisystem Systeminformation
First name = Vorname
Footer = Fußzeile
Forward = Weiterleiten
Forward list is empty! = Liste ist leer!
Forward mail = E-Mail weiterleiten
Forward to = Weiterleiten an
Forward to URL = Weiterleitung zur Domain (URL)<br>(no - keine Weiterleitung)
Free = Frei
free of charge = keine
From = Von
From reseller = von Wiederverk&auml;ufer
Fronpage extensions = Fronpage Extensions
FTP = FTP Transfer
FTP account = FTP Konten
FTP account added! = FTP Konto wurde erfolgreich angelegt!
FTP account already exists! = FTP Benutzername ist bereits vergeben!
FTP account data updated! = FTP Daten wurden aktualisiert!
FTP account deleted successfully! = FTP Konto wurde gel&ouml;scht!
FTP account limit<br><i>(0 unlimited)</i> = Max. FTP Konten<br><i>(0 unbegrenzt)</i>
FTP account(s)<br><i>(0 unlimited) = Max. FTP Konten<br><i>(0 unbegrenzt)</i>
FTP accounts = FTP Konten
FTP Accounts = FTP Konten
FTP accounts limit expired! = FTP Kontenbegrenzung ist &uuml;berschritten!
FTP list is empty! = Es sind keine FTP Benutzer im System vorhanden!
FTP traffic = FTP Transfer
FTP users = FTP Benutzer
FTP<br>traffic = FTP<br>Transfer
FTPs total = FTP Konten gesamt
General information = Allgemeine Informationen
Go back = Zur&uuml;ck
Green = Gr&uuml;n
Group = Gruppenzugeh&ouml;rigkeit
Group already exist ! = Gruppe existiert schon!
Group auth = Gruppenzugeh&ouml;rigkeit
Group members = Mitglieder der Gruppen
Group name = Gruppen
Groups = Gruppen
Has unlimited rights for a <b> = Hat unlimitierte Rechte f&uuml;r ein <b>
Havent you got more than one name? = Haben Sie mehr als einen Namen?
Havent you got more then one name? = Haben Sie mehr als einen Namen?
HDD = HDD
Header = Kopfzeile
hide aliases = Aliase verstecken
High = Hoch
Host = Host
Hosting details = Hosting Paket details
Hosting plan = Hosting Plan
Hosting plan added! = Hosting Paket wurde erfolgreich angelegt!
Hosting plan deleted! = Hosting Paket wurde gel&ouml;scht!
Hosting plan properties = Hosting Paket Eigenschaften
Hosting plan updated! = Hosting Paket wurde aktualisiert!
Hosting plan with entered name already exists! = Hosting Paket ist bereits im System vorhanden!
Hosting plans = Hosting Pakete
Hosting plans available for update = Verfügbare Hosting Pakete
Hosting plans not found! = Es sind keine Hosting Pakete im System vorhanden!
Hour = Stunde
Hour(s): = Stunde(n)
ID = ID
If you want to limit the reseller, fist you must limit its users !<br> = Sie m&uuml;ssen zuerst die Benutzer dieses Wiederverk&auml;ufers begrenzen, um seine Begrenzung bearbeiten zu k&ouml;nnen!<br>
Imagecode description = (Um Missbrauch zu vermeiden, bitten wir Sie die Kombination aus dem Bild in das Feld "Sicherheitscode" einzutippen.)
Implementation URL =  Ziel URL
In front the name = &nbsp;vor dem Datenbank Namen
In this mode only administrators can login = In diesem Modus k&ouml;nnen sich nur Administratoren anmelden!
Incorrect alias range or syntax! = Ung&uuml;ltige <i>Domain Alias</i> Eingabe!
Incorrect city syntax! = Ung&uuml;ltige <i>Stadt</i> Eingabe!
Incorrect company range or syntax! = Ung&uuml;ltige <i>Firma</i> Eingabe!
Incorrect country syntax! = Ung&uuml;ltige <i>Land</i> Eingabe!
Incorrect customer ID syntax! = Ung&uuml;ltige <i>Kundennummer</i> Eingabe!
Incorrect data input! = Falsche Dateneingabe!
Incorrect disk range or syntax! = Ung&uuml;ltige <i>Speicherplatz</i> Eingabe!
Incorrect domain name syntax = Ung&uuml;ltige <i>Domain</i> Eingabe!
Incorrect email range or syntax! = Ung&uuml;ltige <i>E-Mail</i> Eingabe!
Incorrect fax range or syntax! = Ung&uuml;ltige <i>Telefax</i> Eingabe!
Incorrect first name range or syntax! = Ung&uuml;ltige <i>Vorname</i> Eingabe!
Incorrect forward syntax = Ung&uuml;ltige <i>Weiterleitung</i> Eingabe!
Incorrect FTP account range or syntax! = Ung&uuml;ltige <i>FTP Konto</i> Eingabe!
Incorrect mail account range or syntax! = Ung&uuml;ltige <i>E-Mail Konto</i> Eingabe!
Incorrect max alias count or syntax! = Ung&uuml;ltige <i>Max. Domain Aliase</i> Beschr&auml;nkung!
Incorrect max disk amount or syntax! = Ung&uuml;ltige <i>Max. Speicherplatz</i> Beschr&auml;nkung!
Incorrect max domain count or syntax! = Ung&uuml;ltige <i>Max. Domains</i> Beschr&auml;nkung!
Incorrect max FTP count or syntax! = Ung&uuml;ltige <i>Max. FTP Konten</i> Beschr&auml;nkung!
Incorrect max mail count or syntax! = Ung&uuml;ltige <i>Max. E-Mail Konten</i> Beschr&auml;nkung!
Incorrect max SQL databases count or syntax! = Ung&uuml;ltige <i>Max. MySQL Datenbanken</i> Beschr&auml;nkung!
Incorrect max SQL users count or syntax! = Ung&uuml;ltige <i>Max. MySQL Benutzer</i> Beschr&auml;nkung!
Incorrect max subdomain count or syntax! = Ung&uuml;ltige <i>Max. Subdomains</i> Beschr&auml;nkung!
Incorrect max traffic amount or syntax! = Ung&uuml;ltige <i>Max. Transfer</i> Beschr&auml;nkung!
Incorrect mount point syntax = Ung&uuml;ltige <i>Zielverzeichnis (Mount Point)</i> Eingabe!
Incorrect password range or ayntax! = Ung&uuml;ltige <i>Passwort</i> Eingabe!
Incorrect password range or syntax! = Ung&uuml;ltige <i>Passwort</i> Eingabe!
Incorrect phone range or syntax! = Ung&uuml;ltige <i>Telefon</i> Eingabe!
Incorrect post code range or syntax! = Ung&uuml;ltige <i>Postleitzahl</i> Eingabe!
Incorrect price range or syntax! = Falsche Preisangabe!
Incorrect second name range or syntax! = Ung&uuml;ltige <i>Nachname</i> Eingabe!
Incorrect setup fee range or syntax! = Falsche Setupkostenangabe!
Incorrect SQL database range or syntax! = Ung&uuml;ltige <i>MySQL Datenbank</i> Eingabe!
Incorrect SQL user range or syntax! = Ung&uuml;ltige <i>MySQL Benutzer</i> Eingabe!
Incorrect street 1 syntax! = Ung&uuml;ltige <i>Strasse 1</i> Eingabe!
Incorrect street 2 syntax! = Ung&uuml;ltige <i>Strasse 2</i> Eingabe!
Incorrect subdomain range or syntax! = Ung&uuml;ltige <i>Subdomain</i> Eingabe!
Incorrect template description range or syntax! = Falsche Templatebeschreibungsangabe!
Incorrect template name range or syntax! = Ung&uuml;ltige <i>Vorlage Name</i> Eingabe!
Incorrect traffic range or syntax! = Ung&uuml;ltige <i>Transfer</i> Eingabe!
Incorrect username range or syntax! = Ung&uuml;ltige <i>Benutzername</i> Eingabe!
Install = Hochladen
Install new language = Neue Sprachdatei hochladen / aktualisieren (.txt)
Installed languages = Verf&uuml;gbare Sprachen
Installed layouts = Verf&uuml;gbare Layouts
IP = IP Adresse
IP was deleted! = IP wurde gel&ouml;scht
JSP = JSP
Kernel = Kernel
Kill session = Beenden
Label = Name
Language = Sprache &auml;ndern
Language file = Sprachdatei
Last access = Letzter Zugriff 
Last name = Nachname
Last reply = Letzte Antwort
Layout = Design Einstellungen
Layout name = Layout Name
Layout settings = Design Einstellungen
Level = Benutzeroberfl&auml;che
Limit = Begrenzung
Load = Auslastung (Load)
Log is empty! = Protokoll ist leer!
Login = Anmelden
Login with your FTP account = Melden Sie sich via FTP an
Logo file = Logo Datei (.gif, .jpeg, .pjpeg)
Logo upload = Logo hochladen (190x60)
Logout = Abmelden
Lost password = Kennwort vergessen
Lostpw email = Kennwort vergessen E-Mail Einstellungen
Lostpw email setup = Kennwort vergessen E-Mail
Lostpw link = Aktivierungslink
Lostpw message 1 = Aktivierung E-Mail
Lostpw message 2 = Kennwort E-Mail
Low = Niedrig
Mail = E-Mail Konten
Mail account = E-Mail Konten
Mail account already exists! = E-Mail Konto existiert bereits!
Mail account errors = Fehlerhafte E-Mail Konten
Mail account limit<br><i>(0 unlimited)</i> = Max. E-Mail Konten<br><i>(0 unbegrenzt)</i>
Mail account scheduled for addition! = E-Mail Konto wird eingerichtet!
Mail account scheduled for modification! = E-Mail Konto wird aktualisiert!
Mail account scheduler for modification! = E-Mail Konto wird aktualisiert!
Mail account(s)<br><i>(0 unlimited) = Max. E-Mail Konten<br><i>(0 unbegrenzt)</i>
Mail accounts = E-Mail Konten
Mail accounts limit expired! = E-Mail Kontobegrenzung ist erreicht!
Mail accounts list = E-Mail Konten
Mail accounts list is empty! = Es sind keine E-Mail Benutzer im System vorhanden!
Mail forward list error! = Keine E-Mail Weiterleitungen im System vorhanden!
Mail in = E-Mail<br>Eingang
Mail out = E-Mail<br>Ausgang
Mail users = E-Mail Benutzer
Mail were updated successfully! = E-Mail wurde aktualisiert!
Mails total = E-Mail Konten gesamt
Main domain = Hauptdomain
Manage alias = Domain Aliase verwalten
Manage custom menus = Individuelle Men&uuml;punkte verwalten
Manage domain alias = Domain Aliase verwalten
Manage domains = Domains verwalten
Manage hosting plans = Hosting Pakete verwalten
Manage IPs = IP Adressen Verwaltung
Manage orders = Bestellungen verwalten
Manage Orders = Bestellungen verwalten
Manage protected areas, users and groups = Gesch&uuml;tzte Bereiche, Benutzer und Gruppen
Manage SQL = MySQL Datenbanken
Manage user = Benutzer
Manage user sessions = Angemeldete Benutzer verwalten
Manage users = Benutzer verwalten
Manage users and groups = Benutzer- und Gruppen Verwaltung
Mark = Ausgew&auml;hlt
Max aliases count = Max. Domain Aliase
Max aliases count<br><i>(0 unlimited)</i> = Max. Domain Aliase<br><i>(0 unbegrenzt)</i>
Max aliases<br><i>(-1 disabled, 0 unlimited) = Max. Domain Aliase<br><i>(-1 nicht verf&uuml;gbar, 0 unbegrenzt)
Max disk amount [MB] = Max. Speicherplatz [MB]
Max disk amount [MB]<br><i>(0 unlimited)</i> = Max. Speicherplatz [MB]<br><i>(0 unbegrenzt)</i>
Max domain count = Max. Domains
Max Domain count = Max. Domains
Max domain count<br><i>(0 unlimited)</i> = Max. Domains<br><i>(0 unbegrenzt)</i>
Max FTP users count = Max. FTP Konten
Max FTP users count<br><i>(0 unlimited)</i> = Max. FTP Konten<br><i>(0 unbegrenzt)</i>
Max mail users count = Max. E-Mail Konten
Max mail users count<br><i>(0 unlimited)</i> = Max. E-Mail Konten<br><i>(0 unbegrenzt)</i>
Max SQL databases count = Max. MySQL Datenbanken
Max SQL databases count<br><i>(-1 disabled, 0 unlimited)</i> = Max. MySQL Datenbanken<br><i>(-1 nicht verf&uuml;gbar, 0 unbegrenzt)</i>
Max SQL users count = Max. MySQL Benutzer
Max SQL users count<br><i>(-1 disabled, 0 unlimited)</i> = Max. MySQL Benutzer<br><i>(-1 nicht verf&uuml;gbar, 0 unbegrenzt)</i>
Max subdomain count = Max. Subdomains
Max subdomain count<br><i>(0 unlimited) = Max. Subdomains<br><i>(0 unbegrenzt)</i>
Max subdomains<br><i>(-1 disabled, 0 unlimited) = Max. Subdomains<br><i>(-1 nicht verf&uuml;gbar,<br>0 unbegrenzt)</i>
Max traffic [MB] = Max. Transfer [MB]
Max traffic amount [MB] = Max. Transfer [MB]
Max traffic amount [MB]<br><i>(0 unlimited)</i> = Max. Transfer [MB]<br><i>(0 unbegrenzt)</i>
Medium = Mittel
Memory system info = Speicher Systeminformation
Menu button = Men&uuml;punkte
Message = Nachricht
Message subject = Betreff
Message template = Nachrichten Vorlage
Message template info = Vorlage Informationen
Message was send! = Nachricht wurde versandt!
Message was sent. = Nachricht wurde gesendet.
Messages = Anzahl der &uuml;bersetzten W&ouml;rter / S&auml;tze
Minute(s): = Minute(n):
Missing or incorrect data input! = Fehlende oder nicht korrekte Dateneingabe!
Missing or wrong data! = Fehlende oder nicht korrekte Dateneingabe!
Modification in progress = Wird aktualisiert...
Modify = &Auml;ndern
Month = Monat
Month: = Monat
Months(s): = Monat(e):
Mount = Mount
Mount point = Zielverzeichnis (Mount Point)
Move = Verschieben
Moving aborted! = Verschieben abgebrochen!
Multilanguage = Mehrsprachigkeit
MySQL support = MySQL Unterst&uuml;tzung
N/A = N/V
Name = Name
new = neu
New = Neu
New IP was added! = IP wurde hinzugef&uuml;gt
New language installed! = Neue Sprachdatei wurde erfolgreich hochgeladen!
New order = Neue Bestellung
New ticket = Neue Supportanfrage
New VHCS update is now available = Neues VHCS Update ist verf&uuml;gbar!
Next step = N&auml;chster Schritt
no = Nein
No = Nein
No available hosting packages = Keine verf&uuml;gbaren Hosting Pakete
No domain alias system errors = Keine fehlerhaften Domain Aliases im System vorhanden
No domain system errors = Keine fehlerhaften Domains im System vorhanden
No email account system errors = Keine fehlerhafte E-Mail Konten im System vorhanden
No new messages = Keine neue Nachrichten
No new VHCS updates available = Das VHCS System ist auf dem neuesten Stand!
No subdomain system errors = Keine fehlerhaften Subdomains im System vorhanden
No. = Nr.
None = keine
Normal mail = Normale E-Mail
Normal users = Benutzer
Not found reseller(s) in your system! = Er wurden keine Wiederverk&auml;ufer im System gefunden!
Not found user records matching the search criteria! = Es wurden keine mit Ihrer Suchanfrage &uuml;bereinstimmenden Eintr&auml;ge gefunden!
Not in: = Benutzer der Gruppe
Number = IP Adresse
of = von
ok = OK
Ok = OK
OK = OK
Open ticket = Supportanfrage &ouml;ffnen
Open tickets = Offene Supportanfragen
Options = Aktionen
Order = Bestellung
Order data updated successfully! = Bestelldaten erfolgreich aktualisiert!
Order date = Bestelldatum
Order details = Bestelldetails
Order email setup = Vorlagen Einstellungen
Order settings = Einstellungen
Other in = Andere<br>Eingang
Other out = Andere<br>Ausgang
Overview = &Uuml;bersicht
Owner = Besitzer
Package Features = Hosting Paket Merkmale
Package Price = Hosting Paket Preis
Parent Directory = Hauptverzeichnis
Partition = Partition
Password (repeat) = Passwort wiederholen
Password = Passwort
Password data = Passwort
Password data is missing! = Es fehlen Passwort Daten!
Password not match! = Eingegebene Passw&ouml;rter stimmen nicht &uuml;berein!
Password repeat = Passwort wiederholen
Password send = Kennwort gesendet
Password(repeat) = Passwort wiederholen
Passwords does not match! = Eingegebene Passw&ouml;rter stimmen nicht &uuml;berein!
Path = Pfad
Payment period = Zahlungsperiode
Percent = Prozent
Performance = Leisung
Permission deny! = Zugriff verweigert!
Personal data = Pers&ouml;nliche Daten &auml;ndern
Personal Data = Pers&ouml;nliche Daten &auml;ndern
Personal data updated successfully! = Pers&ouml;nliche Daten wurden aktualisiert!
Personalize template = Benutzerdefiniertes Hosting Paket
Phone = Telefon
PHP = PHP Unterst&uuml;tzung
PHP support = PHP Unterst&uuml;tzung
PHP Support: disabled = PHP Support: deaktiviert
PHP Support: enabled = PHP Support: aktiviert
PhpMyAdmin = phpMyAdmin
Please choose user or group = Bitte w&auml;hlen Sie Benutzer oder Gruppe
Please delete first CatchAll account for this email! = Bitte l&ouml;schen Sie zuerst alle CatchAll Konten!
Please enter area name = Bitte geben Sie einen Feldnamen ein
Please enter area path = Bitte geben Sie einen Pfad f&uuml;r den Bereich an
Please enter FTP account username! = Bitte FTP Benutzernamen angeben!
Please enter mail account username! = Bitte E-Mail Benutzernamen angeben!
Please enter SQL query! = Bitte MySQL Query angeben!
Please fill out all needed fields! = Bitte füllen Sie alle benötigten Felder aus!
Please fill up all data fields! = Bitte alle Felder ausf&uuml;llen!
Please fill up both data fields for password! = Keine oder falsche Eingabe!
Please fill up both data fields! = Keine oder falsche Eingabe!
Please select some user(s)! = Bitte Benutzer ausw&auml;hlen!
Please specify a message content! = Bitte geben Sie eine Nachricht ein!
Please specify a message subject! = Bitte geben Sie einen Betreff ein!
Please specify a sender email! = Bitte geben Sie die E-Mail des Absenders an!
Please specify a sender name! = Bitte geben Sie einen Absendernamen an!
Please specify a subject! = Bitte geben Sie einen Betreff ein!
Please specify alias! = Bitte Alias eingeben!
Please specify domain! = Bitte geben Sie eine Domain ein!
Please specify email address! = Bitte geben Sie die E-Mail an!
Please specify message subject! = Bitte geben Sie einen Betreff ein!
Please specify message! = Bitte geben Sie eine Nachricht ein!
Please specify other FTP account dir! = Bitte geben Sie einen anderen FTP Benutzer ein!
Please specify sender name! = Bitte geben Sie einen Absendernamen an!
Please specify some email address! = Bitte geben Sie die E-Mail an!
Please specify some message! = Bitte geben Sie eine Nachricht ein!
Please specify some sender name! = Bitte geben Sie einen Absendernamen an!
Please specify subdomain name! = Bitte geben Sie eine Subdomain an!
Please type database name! = Bitte geben Sie einen Datenbanknamen an!
Please type user name! = Bitte geben Sie einen Benutzernamen an!
Please type user password! = Bitte geben Sie ein Passwort an!
Please type your mail autorespond message! = Bitte geben Sie eine Nachricht f&uuml;r den Autoresponder an!
Please type your message! = Bitte geben Sie eine Nachricht ein!
POP/IMAP = POP3 / IMAP Transfer
Pop/IMAP in = POP3 / IMAP<br>Eingang
Pop/IMAP out = POP3 / IMAP<br>Ausgang
POP3/IMAP traffic = POP3 / IMAP Transfer
POP3/IMAP<br>traffic = POP3 / IMAP<br>Transfer
Preview = Voransicht
Price = Preis
Priority = Priorit&auml;t
Protect it = Sch&uuml;tzen
Protect this area = Bereich sch&uuml;tzen
Protected area created successfully! = Gesch&uuml;tzer Bereich erfolgreich hinzugef&uuml;gt!
Protected area deleted successfully! = Gesch&uuml;tzer Bereich erfolgreich gel&ouml;scht!
Protected area status should be OK if you wannt to delete it! = Der Status vom Gesch&uuml;ten Bereich muss OK sein, wenn Sie diesen l&ouml;schen wollen!
Protected area status should be OK if you wannt to edit it! = Der Status vom Gesch&uuml;ten Bereich muss OK sein, wenn Sie diesen &auml;ndern wollen!
Protected area updated successfully! = Gesch&uuml;tzter Bereich erfolgreich ge&auml;dert!
Protected area was deleted successful! = Schutz wurde aufgehoben!
Protected areas = Gesch&uuml;tzte Bereiche
Protected Areas = Gesch&uuml;tzte Bereiche
Purchase = Bestellen
Purchasing = Zum Kaufen freigegeben
Query result = Query Resultat
Query status = Query Status
RAM = Physikalischer Speicher (RAM)
Real domain = Hauptdomain
Red = Rot
Remove = entfernen
Request password = Kennwort anfordern
Reseller = Wiederverk&auml;ufer
Reseller added = Wiederverk&auml;ufer wurde erfolgreich angelegt!
Reseller and enduser level = Wiederverk&auml;ufer und Kunden Benutzeroberfl&auml;che
Reseller assignment = Wiederverk&auml;ufer zuweisen
Reseller IP list is empty! = Wiederverk&auml;ufer IP Adressen Liste ist leer!
Reseller IPs = Wiederverk&auml;ufer IP Adressen
Reseller level = Wiederverk&auml;ufer Benutzeroberfl&auml;che
Reseller list is empty! = Es sind keine Wiederverk&auml;ufer im System vorhanden!
Reseller name = Wiederverk&auml;ufername
Reseller or user list is empty! = Wiederverk&auml;ufer oder Benutzerliste ist leer
Reseller statistics = Wiederverk&auml;ufer
Reseller statistics table = Wiederverk&auml;ufer Statistiken
Reseller users = Wiederverk&auml;ufer
Reseller users table = Wiederverk&auml;ufer
Resellers = Wiederverk&auml;ufer
Resellers list is empty! = Es sind keine Wiederverk&auml;ufer im System eingetragen!
Reset = Zur&uuml;cksetzten
Restore = Wiederherstellen
Restore backup = Sicherung wiederherstellen
Retry = Wiederholen
Return to previous menu = Zur&uuml;ck zum vorhergehenden Men&uuml;
Routine maintenance!</b><br><br>VHCS is not available for system changes<br><br>Pleas contact your hosting service provider for more information<br><br>We apologize for any inconvenience and thank you for understanding = Wartungsarbeiten!</b><br><br>VHCS ist momentan nicht erreichbar<br><br> Bitte kontaktieren Sie den Systemadministrator f&uuml;r Details<br><be>Bitte entschuldigen Sie etwaige Beeintr&auml;chtigungen und lange Wartezeiten. Wir bitten um Verst&auml;ndnis.
S = Status
Save = Speichern
Save changes = &Auml;nderungen speichern
Search = Suchen
Security code = Sicherheitscode
Send message = Nachrichten senden
Send message reply = Nachricht beantworten
Send message to = Nachricht senden an
Send reply = Antwort senden
Senders email = E-Mail des Absenders
Senders name = Name des Absenders
Server day statistics = T&auml;gliche Serverstatistiken
Server error - please choose error page = Systemfehler - bitte w&auml;hlen Sie Fehlerseite
Server statistics = Serverstatistiken
Server status = Serverstatus
Server traffic = Servertransfer
Server traffic settings = Servertransfer
Server traffic settings updated successfully! = Servertransfer Einstellungen wurden aktualisiert!
Service = Dienste
Service in destination reseller!<br> = Dienst im Ziel-Wiederverk&auml;ufer!<br>
Servicemode = Wartungsmodus
Set server traffic settings = Servertransfer Einstellungen bearbeiten
Settings saved ! = Einstellungen wurden gespeichert!
Setup fee = Einrichtungskosten
Setup Fee = Einrichtungskosten
Show = Anzeigen
Show in = Anzeigen in
Size = Gr&ouml;&szlig;e
SMTP = SMTP Transfer
SMTP traffic = SMTP Transfer
SMTP<br>traffic = SMTP<br>Transfer
Source and destination reseller are the same! = Die ausgew&auml;hlten Wiederverk&auml;ufer sind identisch!
Specified database name already exists! = MySQL Datenbankname ist bereits vergeben!
Specified SQL username name already exists! = MySQL Benutzername ist bereits vergeben!
SQL accounts limit expired! = MySQL Begrenzung ist &uuml;berschritten!
SQL Database = MySQL Datenbank
SQL database = MySQL Datenbanken
SQL database created successfully! = MySQL Datenbank wurde erfolgreich angelegt!
SQL database was removed successfully! = MySQL Datenbank wurde erfolgreich gel&ouml;scht!
SQL database(s)<br><i>(-1 disabled, 0 unlimited) = Max. MySQL Datenbanken<br><i>(-1 nicht verf&uuml;gbar, 0 unbegrenzt)</i>
SQL databases = MySQL Datenbanken
SQL databases limit<br><i>(-1 disabled, 0 unlimited)</i> = Max. MySQL Datenbanken<br><i>(-1 nicht verf&uuml;gbar,<br>0 unbegrenzt)</i>
SQL databases Limit<br><i>(-1 disabled, 0 unlimited)</i> = MySQL Datenbanken Begrenzung<br><i>(-1 nicht verf&uuml;gbar,<br>0 unbegrenzt)</i>
SQL query = MySQL Query
SQL query has error = MySQL Query Fehler!
SQL query is ok = MySQL Query ist OK
SQL support = MySQL Unterst&uuml;tzung
SQL user = MySQL Benutzer
SQL User = MySQL Benutzer
SQL user name = MySQL Benutzername
SQL user password was successfully changed! = MySQL Benutzer Passwort wurde aktualisiert!
SQL user successfully added! = MySQL Benutzer wurde erfolgreich angelegt!
SQL user was removed successfully! = MySQL Benutzer wurde erfolgreich gel&ouml;scht!
SQL user(s)<br><i>(-1 disabled, 0 unlimited) = Max. MySQL Benutzer<br><i>(-1 nicht verf&uuml;gbar, 0 unbegrenzt)</i>
SQL users = MySQL Benutzer
SQL users limit<br><i>(-1 disabled, 0 unlimited)</i> = Max. MySQL Benutzer<br><i>(-1 nicht verf&uuml;gbar, 0 unbegrenzt)</i>
SQL-user limit expired! = MySQL Benutzerbegrenzung wird &uuml;berschritten!
SQL<br>database = MySQL<br>Datenbanken
SQL<br>user = MySQL<br>Benutzer
SSI = SSI
Statistics = Statistiken
Stats = Statistiken
Status = Status
Street 1 = Strasse 1
Street 2 = Strasse 2
Subdomain = Subdomains
Subdomain already exists! = Subdomain existiert bereits!
Subdomain data = Subdomain Daten
Subdomain errors = Subdomain Fehler
Subdomain forward = Weiterleitung<br>(Subdomain)
Subdomain limit expired! = Subdomain Beschr&auml;nkung wurde erreicht!
Subdomain list is empty! = Es sind keine Subdomains im System vorhanden!
Subdomain list is empty! You can not add FTP accounts there! = Es sind keine Subdomains vohanden! Sie k&ouml;nnen kein FTP-Benutzer zu einer Subdomain eintragen!
Subdomain list is empty! You can not add mail accounts! = Es sind keine Subdomains vohanden! Sie k&ouml;nnen keine E-Mail zu einer Subdomain eintragen!
Subdomain mail = Normal<br>(Subdomain)
Subdomain mails = Normal<br>(Subdomain)
Subdomain mount point already exists! = Subdomain Zielverzeichnis (Mount Point) ist bereits vergeben!
Subdomain name = Subdomainname
Subdomain scheduled for addition! = Subdomain wird angelegt!
Subdomain scheduled for deletion! = Subdomain wird gel&ouml;scht!
Subdomain you are trying to remove has email accounts !<br>First remove them! = Die Subdomain, die Sie l&ouml;schen m&ouml;chten hat noch E-Mail Konten!<br>Bitte l&ouml;schen Sie diese zuerst!
Subdomain you are trying to remove has FTP accounts !<br>First remove them ! = Die Subdomain, die Sie l&ouml;schen wollen hat FTP Konten!<br>Bitte l&ouml;schen Sie diese zuerst!
Subdomain(s)<br><i>(-1 disabled, 0 unlimited) = Max. Subdomains<br><i>(-1 nicht verf&uuml;gbar, 0 unbegrenzt)</i>
Subdomains = Subdomains
Subject = Betreff
Submit changes = Aktualisieren
Sum = Gesamttransfer
support question(s) = Supportanfrage(n)
Support question(s) = Supportanfrage(n)
support questions = Supportanfragen
Support system = Supportsystem
Support ticket deleted successfully! = Supportanfragen wurden gel&ouml;scht!
Support tickets = Supportanfragen
suspended = Gesperrt
Suspended = Gesperrt
Swap = Auslagerungsdatei (Swap)
Switch to backup directory = Wechseln Sie in das Verzeichnis <i>backups</i></b>
System error - custom error page was NOT updated! = Fehlerseite wurde nicht gefunden!
System error with Doman ID  = System Fehler mit Domain Nummer (ID)
System info = System Information
System is currently in servicemode! At time only administrators can login. = Das System befindet sich momentan im Wartungsmodus! Zur Zeit k&ouml;nnen sich nur Administratoren anmelden.
System messages = System Nachrichten
System tools = Systemtools
Template name = Hosting Paketname
The current password is wrong! = Das aktuelle Kennwort ist nicht korrekt!
The password was requested = Das Kennwort wurde angefordert
Theme color = Thema
Then the value you are trying to enter now !<br> = als Sie versuchen einzugeben!<br>
Then the value you are trying to enter now!<br> = als Sie versuchen einzugeben!<br>
There are alias with same mount point = Zielverzeichnis (Mount Point) ist bereits vergeben!
There are no available hosting plans for update = Es sind keine Hosting Pakete zum &Auml;ndern vorhanden
There are no available updates = Es sind keine Hosting Pakete vorhanden.
This IP already exist! = IP Adresse ist bereits vergeben!
This reseller has already dispatched more <b> = Dieser Wiederverk&auml;fer hat bereits mehr <b>
This reseller has domains assigned To <b> = Dieser Wiederverk&auml;fer hat Domains verschoben zu <b>
This reseller has more <b> = Dieser Wiederverk&auml;ufer hat mehr <b> 
This reseller has no domains yet. = Dieser Wiederverk&auml;fer hat noch keine Domains.
This reseller has no domains. = Dieser Wiederverk&auml;fer hat keine Domains.
This reseller has user(s) with unlimited rights for <b> = Dieser Wiederverk&auml;ufer hat Benutzer mit unlimitierten Rechten f&uuml;r <b>
This user has domain record !<br>First remove the domain from the system! = Dieser Benutzer hat noch Domains!<br>L&ouml;schen Sie diese zuerst!
This user have domain !<br>To delete user  - first delete domain! = Der zu l&ouml;schende Benutzer hat noch Domains!<br> L&ouml;schen Sie diese zuerst!
This user name already exist! = Benutzername ist bereits vergeben!
Ticket not found! = Supportanfrage wurde nicht gefunden!
Ticket was closed! = Supportanfrage wurde abgeschlo&szlig;en
Ticket(s) are closed! = Supportanfrage(n) wurden abgeschlo&szlig;en
Ticket(s) are deleted! = Supportanfrage(n) wurden gel&ouml;scht!
To Admin = an Administrator
To domain alias = an Domain Alias
To main domain = an Hauptdomain
To reseller = an Wiederverk&auml;ufer
To subdomain = an Subdomain
Too long database name! = MySQL Datebankname ist zu lang!
Too long user password! = Benutzerpasswort ist zu lang!
Too user long password! = Benutzerpasswort ist zu lang!
Total = Gesamt
Traffic [MB]<br><i>(0 unlimited) = Max. Transfer [MB]<br><i>(0 unbegrenzt)</i>
Traffic = Transferverbrauch
Traffic accounting for the selected month is missing! = Es sind keine Daten f&uuml;r den Transferverbrauch vorhanden!
Traffic in MB = Transferverbrauch [MB]<br> (Verbraucht / Begrenzung)
Traffic limit [Mb]<br><i>(0 unlimited)</i> = Max. Transfer [MB]<br><i>(0 unbegrenzt)</i>
Traffic limit [MB]<br><i>(0 unlimited)</i> = Max. Transfer [MB]<br><i>(0 unbegrenzt)</i>
Traffic usage = Transferverbrauch
Traffic<br>usage = Transferverbrauch
Type = Typ
Undefined reference to data! = Systemfehler! Abbruch...
Undefined user accounting error! = Systemfehler! Abbruch...
uninstall = L&ouml;schen
Uninstall = L&ouml;schen
Unknown = Unbekannt
unknown status = Unbekannter Status
Unknown type = Unbekannter Typ
unlimited = unbegrenzt
Unprotect it = Schutz aufheben
Up time = Online Zeit
Update = Aktualisieren
Update data = Daten aktualisieren
Update details = Update Informationen
Update hosting package = Hosting Paket ändern
Update language installed! = Die Sprachaktualisierung wurde erfolgreich durchgef&uuml;hrt!
Update order = Update Bestellung
Update password = Passwort aktualisieren
Update plan = Hosting Paket aktualisieren
Update user = Benutzer aktualisieren
Upload = Hochladen
Upload file error! = Fehler beim Hochladen der Datei!
Upload logo = Logo hochladen (190x60)
Use numeric ID = Pr&auml;fix benutzen
Use other dir = Anderes Verzeichnis
Used = Benutzt
User (first and last) name = Benutzer Vor- und Nachname
User = Benutzer
User account = Benutzerkonto
User accounts = Benutzerkonten
User added = Benutzer wurde erfolgreich angelegt!
User added! = Benutzer wurde erfolgreich angelegt!
User already exist ! = Benutzer ist bereit vorhanden!
User already logged or session sharing problem! Aborting... = Systemfehler! Benutzer ist bereits angemeldet! Abbruch...
User assign = Benutzer zuordnen
User assignment = Kunden zuweisen
User auth = Benutzerzugeh&ouml;rigkeit
User data not updated! = Benutzerdaten wurden nicht</b> aktualisiert!
User data updated! = Benutzerdaten wurden erfolgreich aktualisiert!
User deleted = Benutzer wurde gel&ouml;scht!
User does not exist or you do not have permission to access this interface! = Benutzer wurde nicht gefunden oder Sie d&uuml;rfen sein Konto nicht verwalten!
User does not exist! = Benutzer wurde nicht gefunden!
User language updated successfully! = Sprache wurde erfolgreich aktualisiert!
User login (system) name = Benutzeranmeldung (System Name)
User name = Benutzername
User name too long! = Benutzername ist zu lang!
User not terminated! = Benutzer wurde nicht</b> gel&ouml;scht!
User password = Benutzerpasswort
User password updated successfully! = Benutzerpasswort wurde aktualisiert!
User real (first and last) Name = Kundenname (Vor- und Nachname)
User session was killed! = Die Sitzung f&uuml;r diesen Benutzer wurde erfolgreich beendet!
User sessions = Angemeldete Benutzer
User terminated! = Benutzer wurde gel&ouml;scht!
User type = Benutzertyp
User updated = Benutzerdaten wurden aktualisiert!
User was assigned to group  = Der Benutzter wurde zur folgenden Gruppe hinzugef&uuml;gt:&nbsp;
User was assigned to group = Der Benutzter wurde zur folgenden Gruppe hinzugef&uuml;gt:&nbsp;
User was deleted from group  = Benutzter wurde aus folgender Gruppe gel&ouml;scht!
User was disabled = Benutzer wurde gesperrt!
User was moved = Benutzer wurde verschoben
Username = Benutzername
Users = Benutzer
Users list = Benutzerliste
Users list is empty! = Es sind keine Benutzer im System vorhanden!
Very high = Sehr hoch
VHCS - Admin - Email Marketing = VHCS - Virtual Hosting Control System
VHCS - Admin - Manage custom menus = VHCS - Virtual Hosting Control System
VHCS - Admin/Admin Log = VHCS - Virtual Hosting Control System
VHCS - Admin/Change Password = VHCS - Virtual Hosting Control System
VHCS - Admin/Change Personal Data = VHCS - Virtual Hosting Control System
VHCS - Admin/Internationalization = VHCS - Virtual Hosting Control System
VHCS - Admin/IP manage = VHCS - Virtual Hosting Control System
VHCS - Admin/Lostpw email setup = VHCS - Admin/Kennwort vergessen E-Mmail Einstellungen'
VHCS - Admin/Main Index = VHCS - Virtual Hosting Control System
VHCS - Admin/Manage Sessions = VHCS - Admin/Manage Sessions
VHCS - Admin/Manage Users = VHCS - Virtual Hosting Control System
VHCS - Admin/Manage users/Add reseller = VHCS - Virtual Hosting Control System
VHCS - Admin/Manage users/Add User = VHCS - Virtual Hosting Control System
VHCS - Admin/Manage users/Edit Reseller = VHCS - Virtual Hosting Control System
VHCS - Admin/Manage users/Edit User = VHCS - Virtual Hosting Control System
VHCS - Admin/Manage users/Email setup = VHCS - Virtual Hosting Control System
VHCS - Admin/Manage users/Reseller assignment = VHCS - Virtual Hosting Control System
VHCS - Admin/Manage users/User assignment = VHCS - Virtual Hosting Control System
VHCS - Admin/Reseller User Statistics = VHCS - Virtual Hosting Control System
VHCS - Admin/Server day stats = VHCS - Virtual Hosting Control System
VHCS - Admin/Server statistics = VHCS - Virtual Hosting Control System
VHCS - Admin/Server Traffic Settings = VHCS - Virtual Hosting Control System
VHCS - Administrator/Add hosting plan = VHCS - Administrator/Add hosting plan
VHCS - Administrator/Edit hosting plan = VHCS - Administrator/Edit hosting plan
VHCS - Administrator/Hosting Plan Management = VHCS - Administrator/Hosting Plan Management
VHCS - Circular = VHCS - Virtual Hosting Control System
VHCS - Client : Support System: View Tickets = VHCS - Virtual Hosting Control System
VHCS - Client/Add FTP User = VHCS - Virtual Hosting Control System
VHCS - Client/Add Mail User = VHCS - Virtual Hosting Control System
VHCS - Client/Add SQL Database = VHCS - Virtual Hosting Control System
VHCS - Client/Add SQL User = VHCS - Virtual Hosting Control System
VHCS - Client/Add Subdomain = VHCS - Virtual Hosting Control System
VHCS - Client/Change Language = VHCS - Client/Change Language
VHCS - Client/Change Password = VHCS - Virtual Hosting Control System
VHCS - Client/Change Personal Data = VHCS - Virtual Hosting Control System
VHCS - Client/Change SQL User Password = VHCS - Virtual Hosting Control System
VHCS - Client/Create CatchAll Mail Account = VHCS - Virtual Hosting Control System
VHCS - Client/Cronjob Manager = VHCS - Client/Cronjob Manager
VHCS - Client/Daily Backup = VHCS - Virtual Hosting Control System
VHCS - Client/Domain Statistics = VHCS - Virtual Hosting Control System
VHCS - Client/Edit FTP Account = VHCS - Virtual Hosting Control System
VHCS - Client/Enable Mail Auto Responder = VHCS - Virtual Hosting Control System
VHCS - Client/Enable Mail Autoresponder = VHCS - Kundenbereich / E-Mail Autobeantwortung einrichten
VHCS - Client/Execute SQL Query = VHCS - Virtual Hosting Control System
VHCS - Client/Main Index = VHCS - Virtual Hosting Control System
VHCS - Client/Manage Domains = VHCS - Virtual Hosting Control System
VHCS - Client/Manage Error Custom Pages = VHCS - Client/Manage Error Custom Pages
VHCS - Client/Manage SQL = VHCS - Virtual Hosting Control System
VHCS - Client/Manage Users = VHCS - Virtual Hosting Control System
VHCS - Client/Questions & Comments = VHCS - Virtual Hosting Control System
VHCS - Client/Webtools = VHCS - Virtual Hosting Control System
VHCS - Domain Statistics Data = VHCS - Virtual Hosting Control System
VHCS - Domain/Details = VHCS - Virtual Hosting Control System
VHCS - Domain/Edit = VHCS - Virtual Hosting Control System
VHCS - Manage Domain Alias/Edit Alias = VHCS - Virtual Hosting Control System
VHCS - Manage Domain/Alias = VHCS - Virtual Hosting Control System
VHCS - Manage Mail and FTP / Edit mail account = VHCS - Virtual Hosting Control System
VHCS - Reseller : Support System: View Tickets = VHCS - Virtual Hosting Control System
VHCS - Reseller statistics = VHCS - Virtual Hosting Control System
VHCS - Reseller/Add hosting plan = VHCS - Virtual Hosting Control System
VHCS - Reseller/Change Password = VHCS - Virtual Hosting Control System
VHCS - Reseller/Change Personal Data = VHCS - Virtual Hosting Control System
VHCS - Reseller/Edit hosting plan = VHCS - Virtual Hosting Control System
VHCS - Reseller/Lostpw email setup = VHCS - Reseller/Kennwort vergessen E-Mmail Einstellungen'
VHCS - Reseller/Main Index = VHCS - Virtual Hosting Control System
VHCS - Reseller/Order details = VHCS - Reseller/Order details
VHCS - Reseller/Order email setup = VHCS - Reseller/Order email setup
VHCS - Reseller/Order management = VHCS - Reseller/Order management
VHCS - Reseller/Order settings = VHCS - Reseller/Order settings
VHCS - Support system - New ticket = VHCS - Virtual Hosting Control System
VHCS - Update hosting plan = VHCS - Update hosting plan
VHCS - User/Add user = VHCS - Virtual Hosting Control System
VHCS - User/Add user(step2) = VHCS - Virtual Hosting Control System
VHCS - Users = VHCS - Virtual Hosting Control System
VHCS - Users/Add user = VHCS - Virtual Hosting Control System
VHCS - Users/Edit = VHCS Benutzer bearbeiten
VHCS - Virtual Hosting Control System = VHCS - Virtual Hosting Control System
VHCS Admin / System Tools / Server Status = VHCS - Virtual Hosting Control System
VHCS Client : Add Alias = VHCS Client : Add Alias
VHCS Control Panel = VHCS Administrationsoberfläche
VHCS debugger = VHCS Debugger
VHCS Reseller : Add Alias = VHCS - Virtual Hosting Control System
VHCS updates = VHCS Updates
View = Anzeigen
view aliases = Aliase anzeigen
View details = Details anzeigen
View hosting plan = Hosting Paket anzeigen
View support ticket = Supportanfrage anzeigen
Vital system info = Vital Systeminformation
wait to be added = Wird angelegt, bitte warten...
wait to be deleted = Wird gel&ouml;scht, bitte warten...
wait to be enabled = Wird freigegeben...
wait to be modified = Wird aktualisiert, bitte warten...
wait to be suspended = Wird gesperrt...
Warning traffic [MB] = Transfer Warnung bei [MB]
Warning traffic is bigger then max traffic! = Warnung - Transfer Warnung  ist gr&ouml;&szlig;er als Transfer Begrenzung!
Web & E-Mail Support = Web & E-Mail Service
WEB = Web Transfer
Web in = Web<br>Eingang
Web out = Web<br>Ausgang
Web traffic = Web Transfer
Web<br>traffic = Web<br>Transfer
Webmail = Webmail
Webspace = Speicherplatz / Transfer
Webstatistics = Web Statistiken
Webtools = Webtools
Weekday(s): = Wochentag(e):
which has limits for the <b> = welcher Beschr&auml;nkungen hat f&uuml;r das <b>
Which has limits for the <b> = Welcher Beschr&auml;nkungen hat f&uuml;r das <b>
Wildcards as % and ? are not allowed! = Wildcards ausser % aund ? sind nicht erlaubt!
Wrong data input! = Ung&uuml;ltige Dateneingaben
Wrong domain ID! = Falsche Domain ID!
Wrong domain name syntax! = Falsche Eingabe des Domainnamens!
Wrong IP number! = Ung&uuml;ltige IP Adresse!
Wrong order ID! = Falsche Bestellnummer
Wrong subdomain syntax! = Falscher Subdomain Syntax!
Wrong username! = Falscher Benutzername!
Year = Jahr
Year: = Jahr
Yellow = Gelb
yes = Ja
Yes = Ja
You are exceeding SQL database limit! = Sie &uuml;berschreiten Ihre MySQL Dantenbanken Begrenzung!
You Are Exceeding Your Alias Limit! = Sie &uuml;berschreiten Ihre Domain Aliases Begrenzung!
You are exceeding your disk limit! = Sie haben Ihre Speicherplatz Begrenzung erreicht!
You are exceeding your FTP account limit! = Sie &uuml;berschreiten Ihre FTP Konten Begrenzung!
You are exceeding your mail account limit! = Sie &uuml;berschreiten Ihre E-Mail Konten Begrenzung!
You are exceeding your subdomain limit! = Sie &uuml;berschreiten Ihre Subdomains Begrenzung!
You are exceeding your traffic limit! = Sie &uuml;berschreiten bereits Ihr Transfer Limit!
You are exceeding your UNLIMITED disk limit! = Sie &uuml;berschreiten Ihre UNBEGRENZTE Speicherverbrauch Begrenzung!
You are exceeding your UNLIMITED traffic limit! = Sie haben Ihre Transfer Begrenzung erreicht!
You can not move <b> = Sie k&ouml;nnen den Benutzer nicht verschieben
You can not protect area without selected group(s) = Sie k&ouml;nnen keinen Bereich ohne ausgew&auml;hlte Gruppe(n) sch&uuml;tzen
You can not protect area without selected usre(s) = Sie k&ouml;nnen keinen Bereich ohne ausgew&auml;hlte(n) Benutzer sch&uuml;tzen
You can upload only images! = Sie d&uuml;rfen nur Dateien im angegebenen Format hochladen!
You can upload only text files! = Sie k&ouml;nnen nur Textdateien hochladen!
You do not have new orders! = Es sind keine neuen Bestellungen im System vorhanden!
You do not have permission to access this interface! = Sie besitzen nicht die erforderlichen Rechte, um sich die gewünschte Seite anzeigen zu lassen!
You do not have protected areas = Sie haben noch keine gesch&uuml;tzten Bereiche!
You have = Sie haben
You have alias limit!<br>You can Not Add User With Unlimited Alias Number! = Sie haben eine Alias Beschr&auml;nkung!<b>Sie k&ouml;nnen keine Benutzer mit unbeschr&auml;nkter Alias Anzahl anlegen!
You have been reached your domain limit.<br>You can not add more domains !  = Sie haben Ihre Domain Begrenzung erreicht!<br>Sie k&ouml;nnen keine Domains einrichten!
You have disabled SQL databases for this user!<br>You can not have SQL users here! = Sie haben MySQL Datenbanken f&uuml;r diesen Benutzer deaktiviert! Sie k&ouml;nnen keine MySQL Benutzer anlegen!
You have disk limit!<br>You can not add user with unlimited disk number! = Sie haben eine Speicherplatz Begrenzung!<br>Sie k&ouml;nnen keine Benutzer mit unbegrenztem Speicherplatz einrichten!
You have FTP account limit!<br>You can not Add User With Unlimited FTP Accunt Number! = Sie haben eine FTP Konten Begrenzung!<br>Sie k&ouml;nnen keine Kunden mit unbegrenzten FTP Konten einrichten!
You have mail account limit!<br>You can not add user with unlimited mail accunt number! = Sie haben eine E-Mail Konten Begrenzung!<br>
You have no alias records. = Sie haben keine Alias Eintr&auml;ge.
You have no custom menus. = Sie haben noch keine individuellen Men&uuml;punkte angelegt.
You have no groups ! = Sie haben noch keine Gruppen!
You have no groups! = Sie haben noch keine Gruppen!
You have no hosting plans. Please add first hosting plan or contact your system administrator. = Sie haben noch keine Hosting Pakete. Bitte f&uuml;gen Sie zuerst ein Hosting Paket hinzu oder kontaktieren sie Ihren Administrator.
You have no new support questions! = Sie haben keine neuen Supportanfragen!
You have no support tickets. = Sie haben noch keine Supportanfragen erstellt.
You have no user records. = Sie haben keine Benutzereintr&auml;ge.
You have no users ! = Sie haben noch keine Benutzer!
You have no users! = Sie haben noch keine Benutzer!
You have no users. = Sie haben kein Benutzer.
You have SQL database limit!<br>You can not add user with unlimited SQL database number! = Sie haben eine MySQL Datenbanken Begrenzung!<br>Sie k&ouml;nnen keine Kunden mit unbegrenzten MySQL Datenbanken einrichten!
You have SQL user limit!<br>You can not add user with unlimited SQL users! = Sie haben eine MySQL Benutzer Begrenzung!<br>Sie k&ouml;nnen keine Kunden mit unbegrenzten MySQL Benutzern einrichten!
You have subdomain limit!<br>You can not add user with unlimited subdomain number! = Sie haben eine Subdomainbeschr&auml;nkung!<br>Sie k&ouml;nnen keinen Benutzer mit unbegrenzter Subdomainanzahl hinzuf&uuml;gen!
You have traffic limit!<br>You can not add user with unlimited traffic number! = Sie haben eine Transfer Begrenzung!<br>Sie k&ouml;nnen keine Benutzer mit unbegrenzten Transfer einrichten!
You must assign at least one IP number for a reseller! = Sie m&uuml;ssen einem Wiederverk&auml;ufer mindestens eine IP Adresse zuweisen!
You send email to your users successfully! = Die E-Mails an Ihre Kunden wurden erfogreich gesendet!
Your Chart = Ihre Angaben
Your logo was successful uploaded! = Logo wurde erfolgreich hochgeladen!
Your message = Nachricht
Your message was sent! = Ihre Supportanfrage wurde erfolgreich gesendet!
Your order = Ihre Bestellung
Your Own Domain = Ihre eigene Domain
Your request for hosting pack update was added successfully = Ihre Bestellung für das Hosting Paket Update wurde erfolgreich in das System eingetragen.
Your request for hosting pack update was removed successfully = Ihre Bestellung für das Hosting Paket Update wurde erfolgreich aus dem System gelöscht.
Zip / Postal code = Postleitzahl
Zip/Postal code = Postleitzahl
You have to wait = Wartezeit bis zum n&auml;chsten Anmeldeversuch
seconds = Sekunden
minutes = Minuten
hours = Stunden
days = Tage
You have been blocked for = Sie wurden geblockt für
Group - Usermanagement = Benutzer/ Gruppen
General settings = Allgemeine Einstellungen
Settings = Einstellungen 
Lostpassword = verlorenes Passwort
Activationlink valid (minutes) = Gültigkeitsdauer des Aktivierungslinks (Minuten)
Bruteforce detection = Bruteforce Schutz
Time between logins = Zeit zwischen Anmeldeversuchen
Number of login attempts = Anzahl der Anmeldeversuche 
Blocktime (minutes) = Sperrzeit (Minuten) 
Time between logins (seconds) = Zeit zwischen Anmeldeversuchen (Sekunden) 
Other settings = Andere Einstellungen
Default language = Standardsprache
Supportsystem = Kundenhilfssystem
Domains per page = Domains pro Seite
